1111111111111111111111
1P000000C00000000000C1
1001000001011111110001
100100C00100000C010001
1001111111011111110001
100000C00101000C000V01
1000C00001011111110001
1C00V000000C00000000E1
1111111111111111111111