11111111111111111111111111111111111111111111111111111
10000000000000000C0000000000000000C0000000000000000C1
11101111100000111000110011110001110011101111000011101
1C000000000C000000000100000000C0000001000000000000001
10111111110011111000011001111111001111110001111111101
1000000C0000000000000000000000000000000000C0000000001
10000111100011111110000000000000000011111100011111001
1V000C00000C000C000000000P000000C000C000C000000C000C1
11100000111110001111111001111001111111100001111000001
1C0000000C000000000000000000010000000000000C0000000C1
10000111000011111111111100011110001111110001111100001
1000000000C000C0000000000C000000000C0000000000C0000V1
10001111111000000000000000000000000000000011111111001
1000000000C000C0000000C00000000000C000000C00000000001
10000111110001111110000111110011100011110000001111101
1V0000000000C00000000000000000000C0000000000000000001
10001111111111001111111001111111001111100011111111101
1C000C0000000000000000000C00000000000C0000000000000C1
10001111100011111111000011111111100001111111111111001
10000000000C00000000000000000000000000C00000000000001
10001111110001111111110000111111111110000111111111001
1C0000000C000000000000000000010000000000000C0000000C1
11100000111110001111001111110011111111100001111000001
1000000C0000000000000000000000000000000000C0000000001
101111110011111100001100111E1111001111110001111111101
1C000000000C0000000010000000C0000000100000000000000V1
11111111111111111111111111111111111111111111111111111