1111111111111111111111111111111111111
1C1000000C000110101000000000001C00001
10101010101010001V0000000010001111001
100000000000001000C011110010000000001
1000000000000000000000000010000000001
100110001000100110001C0000100C001C001
100010000000100C111011C11111000011111
10001000001011111P0000000010000000001
10001C00000010000000100000000C00000C1
1V0011100000101C111011C11111000001111
1C101C10000000111000C1000C00000000001
111000001000100000000111111001C000011
1000C00C101010000000V111C0000C00000E1
1111111111111111111111111111111111111