111111111111111111111111
1P10000010000000000000V1
101011101011110111111101
101010001010000100000001
101010111010111101111111
101010001010100101000001
101011101010100101011101
10100C10101000010100C101
100011101011110101111101
100010001000010100000001
111110101111010101111101
1000001000000101C001C001
101111111101110111111101
1V0C1C0000001C010001E001
111111111111111111111111