111111111111111111111111
1P000000C0000000000000V1
101011101011110111C11101
101010001010000100000001
101010111010111101111111
10001C001010100001000001
101011001010100101011101
10100C00101000010100C001
100011001011110101111101
100010001000010100000001
110110101111010101C11101
1000000000000101C000C001
101110011101110111C11101
1V0C1C0000000C000000E001
111111111111111111111111