111111111111111111111111111111111111
1V000000000000C0000000000C0000000001
111011111111100001100111110111110101
1C0000000C000000001000000000000V01C1
101111111000111110000011001110101101
10000C000010000000011110000C00100001
1000111100101110000V0000001111100001
1V0000000C10001C00000000001C000000C1
1110000011111C1111010101100000011111
1C000000001C0000C00001000000000000C1
100011100000011110011101011000111001
1V001C0000000000000C0001C00000100001
10000001100100000111C100001011100001
100000C10001C00000000000C010000010C1
101101110001111001110111E11011100011
1C000000000000000000000C000000001011
101110011001000001110111001111100011
100000C10001C000P0000000C00010001011
1C10000000111C11110101011100100110C1
100000C10000C0000001000000000C0000V1
111111111111111111111111111111111111