11111111111111111111111111111
10000000000000000000000000001
10000000000000000000V00110C01
10000000000000000000000000001
10000001111111111111111111001
10000000000000000000000000001
10000000000000000000V00110C01
10000000000000000000000000001
1EP00001111111111111111111001
10000000000000000000000000001
10000000000000000000V00110C01
10000000000000000000000000001
10000001111111111111111111001
10000000000000000000000000001
10000000000000000000V00110C01
10000000000000000000000000001
11111111111111111111111111111