111111111111111111111111
1P1000001000000000000001
101011101011110111111101
10101000101V000100000001
101010111010111101111111
101010001010100101000001
101011101010100101011101
10100C10101000010100C101
100011101011110101111101
10001V001000010100000001
111110101111010101111101
1000001000000101C001C001
101111111101110111111101
100C0C0000001C0000C1E001
111111111111111111111111