1111111111111111111111111111111111111111111111111111111111111111111111111111111111
10000000000000000000000000000000000000000000000000000000000000000000000000000000P1
1000000000000000101111111010111100000011111101100010111100111111111000000000000001
1000000000000011100000000000000001111110001100011100000001110001100011000000000001
1000000000000011100011000110000001111110001100011100000001110001100011000000000001
1000000000000011100011111110000001000000001110001100011111000001110001100000000001
1000000000000011100011111110000001000110001110000000000111010001110001100000000001
1000000000000111111000001110000111000110000000011100011111010000000011000000000001
1000000000000111111100001110000111000110000000001100011110000000000011000000000001
1000000000001110000000001111000000001110001111101100001100110000110001110000000001
1000000000001100000000001111000000000110001111100000000000110000110001110000000001
1000000000111111011111100000111011110111000000000011111111111111101111110000000001
1000000000111111011111110000111011110111111100000011111111111111101111110000000001
1000000001000000011000000001100000110001100000000111100000011000011100000111100001
1000000000000001011000000001100000110001100000000111000100011000000000000111100001
1000000110000000100000001110000000C11000000011100000011100000001100000000000011001
1000000110000000100000001110000000011001000011000000011100001101100000000000011001
1000001100000000000000001100011100000001000011011000011100001111000000111100000101
1000001100000000000000001100011100001001000011011000000000001111000000100000000101
1000010000001000001000000000111110001101000000000000110100000110000001001100000101
1000000000001000001000000100111110001100000000100000110100000110000000001100000101
1000100000010110110110000110000000000111000010000011100100000110000000110000000001
1000100000010110110110000110000000000111000010000011100100000110000000110000000001
1011000000100010001110000011111100000011000011100000111100000011110000000000001101
1011000000100010001110000011111100000011000011000000111100000011110000000000001101
1011111110000000000110000011000000000000011111011000111100000011001110000011111001
1011111111000000000110000011000100000001111111011000111100000011001110000011111001
1000000000000000000011100000000111111100000000000110000111111100000011111000000001
1V000000000000000000000000000000000000000000000000000000000000000000000000000000E1
1111111111111111111111111111111111111111111111111111111111111111111111111111111111