1111111111111111111111111111111
10000000000000000000000C00000V1
1P00000011111111110111111111101
1111110000000C0000000000000C001
1000000011111110000011111110001
10000C1000000000000000000000001
1011111011101110000010011111111
101000101C000000000010000C00001
1010C000101111C11E11111111111V1
10000010000000000000000000000C1
1011111011111110000010001111111
10000C0000000000000010000000C01
1000111111111110000011111111001
10001C0000000000000000C00000001
1110101111111111111111111111101
1C000000000000000000000000C00V1
1111111111111111111111111111111