11111111111111111111111111111111111111111111
1C001C0000000C00000000C010000C10000000100001
10000V0000010V01000000V0C00000V0000000VC1001
1001101100111C110000011110000111100001111001
10000000000000000000010000000000000001C00001
1011C111101100001101C1011001C11C1101C1001001
100C000000110000110C0001100C0000000C00000C01
1011111C10110000110111C1100111110001111C1001
10000000100C0000C0011000000C000000C110001101
10111C111001111110011P00E0011111110110001101
10000000000000000000000000000000000000000001
1001110000111001C111001111C10011001111C00001
100110C000C100110001101100011011011000011001
1000C0111100001111C110C0C111000C00C000011001
10011001100110C0000110110000C0110110000C0001
1001100000011011000110110001101100111C110001
10000000000000000000000000000000000C100000V1
10011C11000111010000111110001111100011C11001
1000000000000000100000000000001C000000000001
1C100010001000010010001C00000C10000000001101
1C000C1000C0000000C00C10000000000000000000C1
11111111111111111111111111111111111111111111