1111111111111111111111111111111
1V000000000000C00000000000000C1
1C0000000C0000000010000000000V1
1011111110111110000011001111101
10000C0000000000000000000C00001
1000111100111110000000001111101
1V0000000C1C000P0000000C1C000C1
1110000011111011111011111000001
1C0000000C1C0000000000000000001
1000111000000111111101111011101
1V001C000000000000C000000000001
11100001100100000E1111001111101
1C1000C10001C000000000C00000001
1111111111111111111111111111111
