1111111111111111111111111111111
1V00000000000C0000000000000C0P1
1011011111110000111110111100011
1000C1C0000000001C0000C000000C1
1011110111110011100001111011101
1000000C1C0000000000C1C00000001
1001111010111110111000011101101
1V000000000000000C10000000000C1
1011110111001111001111001111101
10000C0000000C0000000000C1C0001
1001111111000111011111110001111
1V0000000000000E000000000000001
1000111110000111001111000111101
10001C000000C0C00C1C0000C000001
1011101110011111011111C11111101
1000000000000000000000000000VC1
1111111111111111111111111111111