1111111111111111111
1000000011P000000E1
1000000100000000001
1000000100000000001
1000000100000000001
1000000100000000001
1000000100000000001
1000000100000000001
11000001010001V1011
1000000000000000001
10000000000000000C1
1111111111111111111