1111111111111111111111111
1V0001C0000000C00000000E1
1000010000000000000000001
1000010000000000000000001
10000100000C0000000000001
10000001000000000000000P1
1000000000000000000000001
1000000000000010000000001
1000000000000010000000011
1000000000000010000000001
1C00000000C0001000000CVE1
1111111111111111111111111