111111
10V0E1
1000C1
1P0001
111111