11111111111111111111111111111
1P000000000000000000000000001
10000C00000000000000C00000001
10111111111111011111111111101
10111111111111011111111111101
1000000C00000000000000000V001
10000000000000000000C00000001
10111111111111011111111111101
10111111111111011111111111101
10000000000000000000C00000001
1000C000000000000000000000001
10111111111111011111111111101
10111111111111011111111111101
10000000000000000000C00000001
100000C000000V00000E00000C001
11111111111111111111111111111