11111111
10V00CE1
10000001
10000001
1P000001
11111111