11111111111111111111111111
1001E000000C110010000000C1
10000111110011000011111001
1P0011C000001100011CE00001
11111111111111111111111111
